OOOOOOOOOOOOOOOOOOO
OFFFFFFFFFFFFFFFFFO
OFOOFOOOFOFOOOFOOFO
OFFFFFFFFFFFFFFFFFO
OFOOFOFOOOOOFOFOOFO
OFFFFOFFFOFFFOFFFFO
OOOOFOOOFOFOOOFOOOO
OOOOFO   E   OFOOOO
OOOOFOFOOOOOFOFOOOO
OOOOFFFOOOOOFFFOOOO
OOOOFOFOOOOOFOFOOOO
OOOOFO       OFOOOO
OOOOFOOOFOFOOOFOOOO
OFFFFOFFFOFFFOFFFFO
OFOOFOFOOOOOFOFOOFO
OFFFFFFFFPFFFFFFFFO
OFOOFOOOFOFOOOFOOFO
OFFFFFFFFFFFFFFFFFO
OOOOOOOOOOOOOOOOOOO